##################
#.....#..........#
#.####.###.####..#
#........#.#..#..#
#.##..##.#....#..#
#..####..#.####.##
###.....##.#.....#
#.#.###....#..##.#
#.###.#....#.##..#
#.....#.#..#..##.#
#.#####.#.##.....#
#.............##.#
#.#######.#####..#
#....#....#...#.##
#.#..#.#..#.#.#..#
#.####.####.#.##.#
#...........#....#
##################