##################
#.....?..........#
#.####.###.####..#
#........#.#..#..#
#.##..##.#....#..#
#..####..#.####.##
#??.....##.#.....#
#.#.###....#..##.#
#.###.#.?..#.##..#
#.....#.#..#..##.#
#.#####.#.##.....#
#.............##.#
#.##?#?##.#####..#
#....#....#...#.##
#.#..#.#..#.#.#..#
#.####.####.?.##.#
#...........#....#
##################