##################
#................#
#................#
#....########....#
#....#...........#
#....#......#....#
#....#......#....#
#....#......#....#
#....#......#....#
#....#......#....#
#....#......#....#
#....#......#....#
#....#......#....#
#...........#....#
#....########....#
#................#
#................#
##################