##################
#................#
#................#
#................#
#...##......##...#
#...##......##...#
#................#
#................#
#.......##.......#
#.......##.......#
#................#
#................#
#...##......##...#
#...##......##...#
#................#
#................#
#................#
##################