##################
#......#..#......#
#.##...#..#...##.#
#.#....#..#....#.#
#................#
#...##......##...#
#...#..####..#...#
#...#........#...#
#......#..#......#
#......#..#......#
#...#........#...#
#...#..####..#...#
#...##......##...#
#................#
#.#....#..#....#.#
#.##...#..#...##.#
#......#..#......#
##################