##################
#................#
#......#..#......#
#....##....##....#
#...#........#...#
#..#..........#..#
#..#..........#..#
#.#............#.#
#................#
#................#
#.#............#.#
#..#..........#..#
#..#..........#..#
#...#........#...#
#....##....##....#
#......#..#......#
#................#
##################