##################
##.#....#.######.#
##........######.#
##........######.#
#..#..#....#####.#
#............#...#
#...##...........#
#.#.#..#.........#
#..####..........#
#...##...........#
#................#
#................#
#................#
##...............#
##..##..###..#...#
##..##..###..#...#
##.###.####.#....#
##################