##################
#................#
#................#
#..##..??..##..###
###..##..##..##..#
#................#
#.?.#.#.#.#.#.?.##
##.#.#.#.#.#.#.#.#
#....#.....?.....#
#????.#...?.?....#
#????#...#.#.#...#
#?????###...#....#
#..........#.....#
#..#.....##??##??#
#...#...#????????#
#..#...#?????????#
#........????????#
##################