##################
#.##.#####.......#
#.#.........####.#
#.#####.###...##.#
#.#.#.....#.#..#.#
#...#.###.####...#
#.#.#...#..#.#.#.#
###.#.#.####.#.#.#
#.....#...#..#.#.#
#..####.#...##.#.#
#.....#####.#..#.#
#.#.#.....#.##.#.#
#.#.#.###.#..#.#.#
#.#.#.#.#.#.##...#
#.#...#.#....#.#.#
#.###.#.####.###.#
#..........#.....#
##################